1,1,1,0,0,0,0,1,1,1
1,7,0,0,6,6,0,0,7,1
1,0,0,9,0,0,9,0,0,1
0,0,0,9,5,5,9,0,0,0
0,0,0,9,5,5,9,0,0,0
1,0,0,0,0,0,0,0,0,1
1,7,0,0,6,6,0,0,7,1
1,1,1,0,0,0,0,1,1,1
