1,1,1,1,1,1,1,1,1,1
1,0,0,0,5,4,6,0,0,0
1,8,1,1,1,1,1,1,0,1
1,0,0,1,1,1,1,1,0,1
1,0,0,0,6,4,5,0,0,0
1,0,4,1,1,1,1,1,1,1
1,0,0,0,0,0,0,7,4,1
1,0,0,0,0,0,0,0,0,1