0,1,0,1,0,1,0,1,0,1
0,0,0,0,0,0,0,0,0,0
1,0,0,0,1,0,6,0,4,0
0,0,0,4,1,0,0,0,0,0
0,1,0,5,0,1,0,1,0,1
0,0,0,0,0,0,0,0,0,0
1,0,4,0,7,1,4,0,1,0
0,1,0,0,0,0,0,0,0,0