1,1,0,0,1,1,1,1,1,1
1,0,0,0,5,4,0,0,0,1
0,0,0,0,0,0,0,0,0,0
0,0,7,6,0,0,0,0,0,1
0,0,0,0,0,0,0,0,0,1
1,0,0,0,0,0,0,0,0,1
1,0,0,0,0,6,8,0,0,1
1,1,0,0,1,1,1,1,1,1